##############################
#&#,,,,#,,,,,#,,,,,#,,,#,,,#&#
#,#,##,#,###,,,###,#@#,#,#,#,#
#,,,,,,,,,,##,##,,,###,#,#,#,#
###,######,#,,,#,,,,,,,,,#,,,#
#,,,,,,,,,,,,,,###,###,#,#,###
#,#,#,########,#P#,#@#,#,#,,,#
#,#,#,#@#,,,#,,,,#,#,,,#,,,#,#
#,,&#,#,#,#,####,#,#,#####,#,#
#,#,#,#,,,#,,,,,,,,,,#,,,,,,,#
#,#,#,########,#####,#,#######
#,,,,,,,,,,,,,,,,,,,,,,,,,,,@#
######,#,#####,#######,#,#####
#&,,,,,#,,,,,,,,,,,,,,,#,,,,&#
##############################