##########
#,,,@#P#&#
#,####,#,#
#,,,,,,,,#
##########